111111111111111111
1P0000000000000001
1000C0000000000011
1000CE000000001111
1000C0000000000011
100000000000000011
111111111111111111